%%%%%%%%%%%%%%%%%%%%
%o...%...P....%...o%
%.%%.%.%%..%%.%.%%.%
%...... G GG%......%
%.%.%%.%% %%%.%%.%.%
%.%....% ooo%.%..%.%
%.%.%%.% %% %.%.%%.%
%o%...........%....%
%%%%%%%%%%%%%%%%%%%%
