%%%%%%%%%%%%%%%%%%%%%%%%%%%%%%%%%%%%%%%%%%%%%
% P...........o%..%.%...................o...%
%  %%%%%%%%%%%.%..%.% %%%% %%%%%%%%%%%% %%%%%
%.....................%..... %GG% ... %.....%
%%%.%%%%%%%%%%%%% %%%%%%%%%  %  %     %  %..%
%...%...................%   .......   %..%..%
%..%%  %%%%%%%%%%%%%......%%%%%%%%%%  %..%  %
%.%%%  %.....o.....%    %   ...........  %..%
%.......................% .  %%%%%%%%%%%%% %%
%   %%%%%%%%%%%%%%%%%%  %...................%
%  o......................%%%%%%%%.......%.o%
%%%%%%%%%%%%%%%%%%%%%%%%%%%%%%%%%%%%%%%%%%%%%