%%%%%%%%%%%%%%%%%%%%%%%%%
%.. P  ....      ....   %
%..  o..  o..  ...  ... %
%..  ...  ...  ...  ... %
%..    ....      .... o %
%..  ...  ...  ...  ... %
%..  ...GGG..  ...  ... %
%..              ....  o%
%%%%%%%%%%%%%%%%%%%%%%%%%
